. . x x x x x _ . .
. . . x . . x x . .
. . . x . . . . . .
. . _ _ _ . . . . .
. . _ _ _ . . . . .