. . . . _ . x _ . .
. . . x . . x x _ _
. . . x . . . x . _
. . _ _ _ . . . . .
. . _ . . x x x x .